минэкономразвития: минэкономразвития
предложить: предложили предложило предложить предложил предложит
дать: дайте данные дать дали данной даст данная
свобода: свободы свободой
разработчик: разработчиками разработчик разработчика разработчиков разработчику разработчиком разработчики разработчикам
воздушный: воздушного воздушным воздушное воздушные воздушных
наземный: наземных
беспилотник: беспилотников
хабра: хабр хабре хабра
всё: всё все
сервис: сервис сервисах сервисами сервисом сервисов сервисы сервису сервиса сервисе
министерство: министерство
экономический: экономические экономического экономическое
развитие: развитию развитие развития развитием
подготовить: подготовили подготовил подготовило
законопроект: законопроекта законопроект
который: которой которая котором которую которого которым который которое которых которому которыми которые
подразумевать: подразумевает
возможность: возможность возможностей возможностями возможностях возможности
корректировать: корректировать
отменять: отменять
норма: нормам норм норму нормы
закон: законов закона закон законам закону законы
безопасность: безопасности безопасность безопасностью
дорожный: дорожного
движение: движений движения движению
защита: защита защиты защите
персональный: персональными персональных
данные: данными данным данных
кодекс: кодекса кодексы кодексом
также: также
обязательный: обязательном обязательного обязательна обязательную
автострахование: автостраховании
гражданский: гражданской
ответственность: ответственность ответственности
участник: участникам участники участниками участников участника
испытание: испытание испытаний испытания
инновационный: инновационного инновационных
транспортный: транспортных транспортного
средство: средствами средства средств
ведомость: ведомости ведомостям
сейчас: сейчас
корректировка: корректировка корректировок
правило: правила правилах правило правилами правил
тестовый: тестовой тестовые тестовый тестовое тестовых
зона: зон зоны зона зоне зонах зону
эксперимент: экспериментов эксперименты эксперимента
возможный: возможным возможных возможного возможна возможные возможной
согласно: согласно
принять: приняли принят принято принятые принять принятому приняты примет приняло примут
прошлый: прошлой прошлых прошлом
год: годом годы годов лет гг год году года годам
экспериментальный: экспериментальных экспериментального экспериментальной
правовой: правовых
режим: режима режимов режим режиме режимах режиму
эпр: эпр
сфера: сфере сферы
инновация: инноваций инновациям
тем: тем
менее: менее
изменение: изменения изменениях изменений изменениям изменение
мочь: можем мог могло могли могут можете могла
противоречить: противоречить противоречит
действовать: действовать действующему действует действуют
законодательство: законодательстве законодательства законодательству законодательством законодательство
поправка: поправками поправки поправок
призвать: призвал призваны
решить: решил решённых решили решила решить решено
проблема: проблемам проблемами проблем проблему проблемы проблема проблемой проблемах проблеме
учитывать: учитывая учитывают
основание: основания оснований основанию основании
временной: временной
приостановка: приостановки
действие: действия действий действиям
нормативный: нормативных нормативные
акт: актов акты
отдельный: отдельным отдельные отдельных отдельными
территория: территорий территориях территории
частность: частности
нужно: нужно
ставить: ставить
учёт: учётом учёт
требовать: требуют требует требовать требуемую требующий
нынешний: нынешняя нынешние нынешнее нынешней нынешним
отменить: отменил отменить отменено
пересмотреть: пересмотреть пересмотрено
требование: требования требование требованиям требований
страхование: страхования страховании
владелец: владельцам владельцем владельцы владельцев владелец владельце владельца
транспорт: транспортом транспорта
медосмотр: медосмотра
новый: новые новый новая новому новейшими новой новым новых нового новое новыми новом новую
отчасти: отчасти
развязать: развяжет
рука: руки руке
позволить: позволить позволило позволят позволили позволит
проводить: проводить проводили
запуск: запусков запуску запуска запуском запуске запуски запуск
вне: вне
прямой: прямая прямым прямой прямых прямыми
радиовидимость: радиовидимости
такой: такая таким такими такого таких такое такую такому такие
например: например
планироваться: планируется планировалось планируются
томский: томской
область: областях области область
рамка: рамок рамках рамки
проект: проектов проекте проекту проектом проектам проект проекта проектах проекты
тайга: тайга
фонд: фонды фонда фонд
перспективный: перспективных перспективные перспективная
исследование: исследованиях исследование исследованиями исследованию исследований исследовании исследования
более: более
проверка: проверку проверка проверкам проверки
технология: технология технологиям технологий технологию технологией технологии технологиями технологиях
постепенно: постепенно
интегрировать: интегрированных интегрирует интегрировать
беспилотный: беспилотными беспилотные беспилотной беспилотных
судный: судна
общий: общее общая общие общем общий общего общей
пространство: пространство пространства пространстве
россия: россия россии россию
говорить: говорит говорят говоря говорил говорить
лидер: лидеров лидер
рабочий: рабочий рабочее рабочей рабочая рабочих
группа: группа группы группу группам групп группах
аэронуть: аэронет
национальный: национальной национальное
технологический: технологического технологический технологические технологической технологических
инициатива: инициативу инициативы инициатива
нти: нти
сергей: сергей
жуков: жуков
подобный: подобные подобная подобных
минтранс: минтранс
готовить: готовил
концепция: концепцию
интеграция: интеграцией интеграцию интеграции
ещё: ещё еще
согласовать: согласована согласует
правительство: правительством правительство правительстве правительства
пресссекретарить: пресссекретарь
ано: ано
платформа: платформу платформе платформы платформах платформа
юрий: юрий
сушиновый: сушинов
отметить: отметила отметил отметили отметить
быть: будем будут будь будучи
работать: работал работали работать работавших работающими работающих работают работает
совместно: совместно
допускать: допускает
полёт: полёты полетов полета полет
определить: определить определена определит
конкретно: конкретно
проходить: проходят проходить проходит
первый: первую первый первая первые первой первого первое первым
программа: программа программу программе программы программ
утвердить: утвердят
ранее: ранее
конец: концу конец конца конце
работа: работой работа работе работы работу
они: ними им они ими
начаться: начались начнется начнётся началась
этот: эта этих этой этому эти этот
время: времён время временем времени
должный: должна должны должно должен
разработать: разработал разработает разработаны разработана разработать разработала разработанные разработан разработало
уточнять: уточняет уточняют уточняя
автомобиль: автомобилей автомобиль автомобилем автомобили
считать: считает считаем считают считать считаю
принятие: принятия принятие
благоприятно: благоприятно
отразиться: отразится
рынок: рынках рынка рынке рынку рынком
набрать: набрать набрало
необходимый: необходимой необходимым необходимых необходимы необходим необходимые необходимую
статистика: статистики статистике статистика
представитель: представителя представитель представителей представители
компания: компанию компании компания компанией компаний компаниями
яндекс: яндекса яндексе яндекс
улица: улицах
столичный: столичного
технопарк: технопарка
сколково: сколково
иннополис: иннополиса
татарстан: татарстан
тельавив: тельавива
город: город города городе городов городах
эннарбор: эннарбор
сша: сша
присылать: присылаемого присылаем
хороший: хорошие лучшей лучшую лучшие хороший хорошая лучшее хорошей
статья: статью статьях статьи
месяц: месяцами месяце месяцы месяца месяц месяцев
скоро: скоро
адрес: адрес адреса
прийти: придет пришло прийти
письмо: письме письма письмо
подтвердить: подтвердить подтвердил подтвержденным подтвердите подтвердили
подписка: подписке подписок подписку подписка
сила: силами силу силе
редактор: редактор редакторе редактора
только: только
оставлять: оставлять
комментарий: комментарий комментариях комментариев комментарии комментария
пожалуйста: пожалуйста
шереметьево: шереметьево
домодедово: домодедово
распознавать: распознавать
лицо: лицам лица лиц лицами лицу
пассажир: пассажиров пассажира пассажирам
вместо: вместо
паспорт: паспорта
автоматический: автоматическая автоматического автоматический автоматическое автоматическом автоматической автоматическими
регистрация: регистрации регистрацию регистрация
рейс: рейсов рейс
аэропорт: аэропортов аэропорты аэропорт аэропортах аэропорту
гатвика: гатвик
великобритания: великобритания великобритании
система: системе системами системой систему систем системах системы система системам
распознавание: распознавание распознавания распознаванию
модернизация: модернизации модернизация
предполагать: предполагая предполагают предполагает предполагали
установка: установку установки установка установок
видеокамера: видеокамер
автоматизированный: автоматизированных
турникет: турникетах
egate: egate
именно: именно
таможенный: таможенные таможенного
контроль: контроля контроль
галерея: галерее
вылет: вылета
международный: международному международной международных международную международный
выход: выходом выходов
посадка: посадки посадку
это: это этим
делаться: делается
удобство: удобства
повышение: повышении повышение повышения
прибыль: прибыль прибыли прибылью
ускорение: ускорения
предполётный: предполётных
процедура: процедурами процедур процедуру
становиться: становятся становится
полностью: полностью
участие: участия участии участие
человек: людьми людям людей человек человека человеку люди
предъявление: предъявления
момент: момента момент
самолёт: самолёта самолетами самолёт
чтобы: чтобы
воспользоваться: воспользоваться
гражданин: гражданин гражданам граждан граждане
рф: рф
обязать: обязан
сдать: сдать
единый: единую единому единое единого единой единый
биометрический: биометрической биометрическую биометрических биометрические
ебс: ебс
один: одного одном одни одних один одной одним одну одному одна
отделение: отделений
банк: банков банка банком банк
согласие: согласия согласие
использование: использовании использованием использование использованию использования
биометрия: биометрии
конкретный: конкретные конкретное конкретных конкретную конкретного
цель: цели цель целях целью целей
аналогичный: аналогичная аналогичный аналогичные аналогичных аналогичную
вести: ведёт ведет вести ведут
внедрить: внедрит внедрить внедренные внедрили
готовый: готова готов готовы готовых
сразу: сразу
федеральный: федеральный федерального федеральные федеральная федеральной федеральную
авиационный: авиационные
модернизировать: модернизированы
государственный: государственная государственного государственные государственных государственном государственной
активно: активно
внедряться: внедряются
хитроу: хитроу
караско: караско
уругвай: уругвай
гонконг: гонконге
дубай: дубае
мексика: мексике
другой: другим другими другого другая другое других другому другие
страна: странах стран страна стране странами страны
авиакомпания: авиакомпания
lufthansa: lufthansa
осуществить: осуществила осуществят
минута: минутах минут
помощь: помощи помощью
свой: своём своя своё свое своими своим своих свои свой своей своего своем
лосанджелес: лосанджелеса
благодаря: благодаря
идентифицировать: идентифицировала идентифицировать идентифицирующей
далёкий: дальше
считывать: считывать
открывать: открывать
гейт: гейты
посадочный: посадочным посадочная посадочного
талон: талона
если: если
применять: применяют применяем применять применяя
будущее: будущем будущее
помочь: помогут помогла поможет помочь
автоматизировать: автоматизировать
задача: задачи задача
сначала: сначала
затем: затем
таргетинг: таргетинга таргетинг
реклама: рекламе рекламы рекламу реклама
персонализация: персонализация персонализации
услуга: услугами услугу услуг услуги
салон: салоне
далее: далее
трансформироваться: трансформироваться
дружелюбный: дружелюбное
цифровой: цифровые цифровое цифровым цифровую цифровой цифровых цифровая цифрового
комфортно: комфортно
получать: получать получают получал получает
грамотный: грамотный
инструмент: инструменты инструментов инструмент инструменте инструмента инструментом
увеличение: увеличение увеличения увеличением
неавиационный: неавиационных
доход: доходов доход доходы
дмитрий: дмитрий
дырмовский: дырмовский
генеральный: генеральный генеральным
директор: директора директором директоров директор
црт: црт
хакер: хакер хакерам хакеров хакеры
исследователь: исследователю исследователи исследователь исследователями исследователям исследователя исследователей
создать: созданные созданная создать создавшая создана создано создан создаст созданный создали создадут созданными созданном
ия: ии
тренировать: тренирует тренировать
собака: собак собака собаку
команда: командой команды команде команда команд командам
университет: университет университетов университета
штат: штата штат штатов штате штатах
колорадо: колорадо
nvidia: nvidia
jetson: jetson
edge: edge
тысяча: тысячу тысячи тысячах тысячам тысяче тысяч
изображение: изображение изображения изображений изображении
теперь: теперь
способный: способную способны способные способна
питомец: питомец питомцев
определять: определяет определяя
сидеть: сидит
стоить: стоил стоит
лежать: лежит
занимать: занимает занимать
нужный: нужные нужна нужен нужное нужны
положение: положение положением положения положениях
вознаградить: вознаградит
пёс: пса
автоматически: автоматически
подавать: подавать подавая
угощениеджейсон: угощениеджейсон
сток: сток стока
тот: том тех та тому те той
кэви: кэви
аспирант: аспиранты аспирант
факультет: факультета
информатика: информатики
обучение: обучения обучение
разный: разные разных разного
использовать: используемого используя использовать использовали использовала используют используемых используемая используемые использовал используем используемый использовало использует
камера: камер камерой камеры камерами камеру камера камерах
смочь: смогли смогла смогут сможет смог
проанализировать: проанализировать проанализировали
испытывать: испытываемых испытывал испытывают
доля: долей доли
секунда: секунду секунды
точность: точность
тестирование: тестировании тестирования тестирование тестированием тестированию
составить: составят составило составит составила составил составить
скорость: скорость скоростью скорости
около: около
кадр: кадров
секундуисследователь: секундуисследователи
дрессировщик: дрессировщики
дрессировать: дрессировать
удалённый: удаленная удалённой удаленный удаленного удалённо удаленную удаленно удалённого удаленной
хабраредактор: хабраредактор
минцифра: минцифры
отложить: отложить
переход: перехода переходе переход
набор: наборы набору набор набора наборах
номер: номеров номера номерами номер
восьмёрка: восьмерки
связь: связи связь связью
массовый: массовому массовых массового массовое массовой массовым
коммуникация: коммуникаций коммуникации
опубликовать: опубликовать опубликовал опубликованным опубликовали опубликованных опубликуют опубликовало опубликовав опубликованном опубликована
приказ: приказа приказ
цифра: цифра цифры
абонент: абоненту абонентов абонента абоненты
междугородний: междугородних
вызов: вызовах вызовов
набирать: набирать набирает
рбк: рбк
нумерация: нумерации
состояться: состоялась состоятся состоялся состоится
впервые: впервые
идея: идея идей идею
возникнуть: возникли возникшие возникла возникшем возникнут
поэтапный: поэтапным
этап: этапа этапов этапы этапе этап
префикс: префиксов префикс префиксы
междугородный: междугородных
звонок: звонками звонках
на: на
второй: второй вторая вторую второго втором
рассчитать: рассчитан
период: периодам период периодом
предлагать: предлагает предлагали предлагают
перейти: перешел перейти перейдя перешла
закрытый: закрыт закрытый закрыта закрытых
план: плане планах планам планов планы план плану
местный: местные местным местной местных
открытый: открытым открытой открытый открытом открытых открытого
внутригородской: внутригородских
достаточно: достаточно
пять: пять пяти
шесть: шесть шести
семизначный: семизначный
прийтись: придётся пришлось придется
добавлять: добавлять добавляют
соответствовать: соответствуют соответствовали соответствует соответствующей соответствующий
код: кода коды кодом кодами код
закрепить: закрепить
служба: службой служба службе служб службы
оперативный: оперативную оперативной оперативного
вопрос: вопросов вопросом вопросам вопросы вопрос вопросу
оказание: оказание оказания
медицинский: медицинских медицинской
врач: врачами
коронавирусный: коронавирусной
инфекция: инфекцией инфекции
ноябрь: ноября ноябре
пандемия: пандемии пандемией
коронавирус: коронавирус коронавирусом коронавируса
решение: решении решений решением решения решению решение
общаться: общаюсь общаются общаться
лишний: лишнего
ожидание: ожидания
ведомство: ведомство ведомства ведомстве
пояснить: пояснил пояснили пояснила пояснено
весь: всей всем всему всеми вся весь всего
слово: слова слову словам
острый: острой
необходимость: необходимости
поэтому: поэтому
перенести: перенести
комфортный: комфортные
срок: сроки срок
глава: глава
минсвязи: минсвязи
леонид: леонид
рейман: рейман
декабрь: декабря декабрь декабре
изменить: изменили изменить
экстренный: экстренных экстренной
начинаться: начинались начинается
нуль: нуля
москва: москве москва москвы
предыдущий: предыдущая предыдущими предыдущих предыдущего предыдущие
изначально: изначально
однако: однако
впоследствии: впоследствии
неоднократно: неоднократно
откладываться: откладывалась
украсть: украденные украденных украли
cd: cd
projekt: projekt
red: red
продать: продадут продал проданы
аукцион: аукционе аукциона аукцион
по: по
telegramканал: telegramканал
утечка: утечку утечки утечка утечкой утечек утечке
информация: информация информацию информацией информации
февраль: феврале февралю февраль февраля
злоумышленник: злоумышленникам злоумышленник злоумышленников злоумышленнику злоумышленники
досрочно: досрочно
прекратить: прекратит прекращена прекратил прекратить прекратили
продаваться: продавались
студия: студия студии студию
включая: включая
исходный: исходным исходных исходные исходными исходному исходный
cyberpunk: cyberpunk
ведьмак: ведьмака
продавец: продавцом продавец
получить: полученные получат получила полученной получено полученных получит получить получив получите получил получили получивших
выгодный: выгодное выгодным
предложение: предложения предложение предложениям
торг: торгов торги
площадка: площадки площадка площадок площадке площадкой
exploit: exploit
посредник: посредниками посредников посредника
стартовый: стартовая
цена: ценам цен цене цены цена
составлять: составляли составляла составляет составлять
млн: млн
шаг: шагом шаг
тыс: тыс
выкупить: выкупить
предполагаться: предполагалось предполагалась
длиться: длиться
час: час часа часов
факт: факту фактов факт
ставка: ставки ставка ставками
покупатель: покупатели покупатель
сделать: сделанным сделанные сделал сделали сделана сделав сделано сделать
лот: лот
снятой: снят
выкуп: выкуп
платить: платить платил платят платит
инженер: инженеры инженер
редакция: редакция редакции
дуров: дуров дурова
рассказать: рассказала расскажем расскажет рассказал рассказали расскажут
монетизироваться: монетизироваться
telegram: telegram
павел: павел
канал: канала каналов канал каналы каналах каналу канале
создатель: создатели создателя создатель создателей
мессенжер: мессенжера
старый: старых старым старому старые старый
особенно: особенно
пользователь: пользователям пользователями пользователях пользователей пользователя пользователи пользователь пользователю пользователем
беспокоиться: беспокоиться
собираться: собираются собирается собираться
фактически: фактически
контекстный: контекстная контекстной
основать: основали основанная основана
тематика: тематике
подытожить: подытожил
традиционный: традиционной традиционным традиционные
социальный: социальных социальная социальные социальным
сеть: сеть сети сетей сетях
переслать: перешли перешлют
дозволить: дозволенные дозволенного
эксплуатация: эксплуатации
издатель: издателей
чрезмерный: чрезмерного чрезмерным
сбор: сбора сбор
манипулятивный: манипулятивных
алгоритм: алгоритм алгоритма алгоритмов
он: нём он ему его нему
хотеть: хочет хотите хотят хотело хотели хотел
начало: начале начала начало
январь: январь января январе
появиться: появится появилась появятся появиться появился появилось
крупный: крупнейшую крупных крупный крупнейшая крупнейших
создавать: создавать создают создавали создавая создавал создает
больший: больших большей большая большим большего большему большую большими больший
нагрузка: нагрузок нагрузку нагрузкам нагрузки нагрузкой
сервер: серверах серверы серверов серверам сервера
прошлое: прошлого
монетизация: монетизации
текущий: текущей текущего текущая текущим текущие текущих текущий текущем
остаться: останутся останется
бесплатный: бесплатная бесплатный бесплатное бесплатные бесплатными
дополнительно: дополнительно
число: число числа числе числом
платный: платные платная платной
функциональность: функциональность
бизнескоманда: бизнескоманд
расширить: расширить расширят расширенными расширила расширили
потребность: потребности потребностей потребностями
наса: наса
забронировать: забронировать
место: месте мест местах места место
апрельский: апрельской апрельская апрельском
союз: союзе союза союзах
мкс: мкс
планировать: планируемом планируемых планирует планируют планировал планировали
астронавт: астронавта астронавты астронавтов
следующий: следующие следующего следующая следующем следующей следующих следующим
космический: космических космическому космическую космического космической космическом
станция: станций станцией станции станция станцию
наметить: намечена наметить намечено намечен
апрель: апреля апрель апреле
агентство: агентстве агентство агентства
присутствие: присутствия присутствие присутствии
случай: случаев случае случаях
задержка: задержку задержках задержки
графика: графики графике графика
коммерческий: коммерческих коммерческую коммерческим коммерческой коммерческом коммерческая коммерческие
миссиить: миссиив
сводить: сводит
минимум: минимуму минимум
риск: риск рисков риски рисками риска
связанный: связанной связанные связанным связанными связанную связанных
прерывание: прерывания прерыванием
член: член членов
экипаж: экипажа экипажей экипажем
мксв: мксв
сообщать: сообщала сообщал сообщать сообщает сообщают сообщаем сообщало сообщали
миссия: миссий миссией миссия миссии миссиями
запланировать: запланирован запланирована
между: между
boeing: boeing
starliner: starliner
совершить: совершит
испытательный: испытательный
сентябрь: сентябрь сентябре сентября
второе: второе
март: марта март марте
робин: робин
гейтенс: гейтенс
ио: ио
штабквартира: штабквартире штабквартира
закупать: закупать
кресло: кресла
смешанный: смешанных
американский: американский американские американских американской американским
летать: летать
российский: российском российского российскими российское российскую российской российских российскому российские российским российский российская
космонавт: космонавты космонавта космонавтов
корабль: корабля корабле кораблях
организовывать: организовывали
похожий: похожей похожая похожую
мир: миру мир мире мира
шаттл: шаттл шаттлами шаттла
доставляться: доставлялись
орбита: орбитах орбита орбиты орбиту орбите
экспедиция: экспедиции
орбитальный: орбитальный орбитального орбитальной
стыковка: стыковка
атлантиса: атлантис
произойти: произошёл произошла произойдёт произошедшем произойти произошло произойдет произошел произошедшим
свернуть: свернули
годуследующий: годуследующий
олег: олега олегу олег
новицкий: новицкий
пётр: петр
дубров: дубров
корсак: корсаков
освободить: освободить
американец: американца
исключить: исключено исключить
стать: стало стать стала стали статей стал станут станет
исключительно: исключительно
последний: последние последних последнее последняя последний последними последнем последней
десятилетиять: десятилетияв
роскосмос: роскосмосе роскосмоса роскосмос
заявить: заявили заявил заявила
официально: официально
оформить: оформить
отношение: отношению отношение отношении отношения
партнёр: партнера партнеров партнёр партнерами
какой: какими каких каком какие
условие: условий условиям условиях условиями условием условия
соглашенияпервать: соглашенияпервая
spacex: spacex
майкл: майкл
хопкинс: хопкинс
виктор: виктор
гловера: гловер
шеннон: шеннон
уокер: уокер
японец: японец
соич: соичи
ногучить: ногучи
завершиться: завершится завершились завершиться
май: мае мая
причина: причине причин причина причину причиной
взлом: взломом взлома
очистный: очистных очистные очистной
сооружение: сооружений сооружения
пароль: пароль паролями паролей пароля пароли
teamviewer: teamviewer
отсутствие: отсутствии отсутствие отсутствия
брандмауэр: брандмауэр брандмауэра брандмауэров
власть: власти властей
массачусетс: массачусетса массачусетс
предупреждение: предупреждение предупреждения предупреждению
компаниямпоставщик: компаниямпоставщикам
водоснабжение: водоснабжению водоснабжения
инцидент: инциденте инцидент инцидентом инцидента
водоочистный: водоочистной водоочистных
флорида: флориде флорида
олдсмара: олдсмар
запад: западе
сообщение: сообщении сообщений сообщения сообщение
ссылаться: ссылается ссылаются
уведомление: уведомление уведомления
фбр: фбр
взломесогласный: взломесогласно
многочисленный: многочисленные многочисленных
нарушение: нарушений нарушения нарушение нарушении
сторона: стороны сторону сторон стороне сторона
сотрудник: сотрудникам сотрудниках сотрудников сотрудник сотрудники
руководитель: руководителя руководителей руководитель
предприятие: предприятий предприятиях предприятиям предприятия предприятие предприятием
слабый: слабых слабой слабые
кибербезопасность: кибербезопасности
ars: ars
technica: technica
ссылка: ссылкой ссылку ссылки ссылок ссылка
удаться: удастся удалось
захватить: захватили захватить
короткий: коротких короткое короткий
итог: итогам итогов итоге
привести: привела привели привело приведет привести
непоправимый: непоправимым
последствие: последствиям последствия
утверждаться: утверждалось утверждается
доступ: доступ доступа доступе доступов доступу
программный: программный программных программное программного программному программном программной
обеспечение: обеспечение обеспечению обеспечения обеспечении обеспечением
scada: scada
управлять: управляет управляют управляющий управлять
вход: входе входа
кроме: кроме
компьютер: компьютере компьютерах компьютером компьютеры компьютеров
устаревший: устаревшим устаревший устаревшей устаревшую
windows: windows
помимо: помимо
прочее: прочего
отсутствовать: отсутствовал отсутствуют
скриншот: скриншотами скриншот
оказывать: оказывающих оказывать
водоснабжениювластить: водоснабжениювласти
список: списка списком списке список списку
рекомендация: рекомендаций рекомендации
поставщик: поставщика поставщиков поставщикам поставщиком
вода: воде вода воду воды
посоветовать: посоветовали посоветовал
ограничить: ограничить ограничена ограничен
подключение: подключение подключении подключением подключения
осуществляться: осуществляться осуществляется
физический: физического физическими
процесс: процессов процессами процессах процессы процесса процессе процесс
рекомендовать: рекомендуют рекомендует рекомендуем рекомендовать
актуальный: актуальна актуальные
версия: версии версией версиями версиях версию версий версия
ввести: введет введен ввести
двухфакторный: двухфакторную
аутентификация: аутентификацию аутентификации
надёжный: надежная надёжный надёжными
безопасный: безопасным безопаснее безопасные безопасных безопасной
олдсмаре: олдсмаре
городской: городского
офис: офис офиса
ответить: ответила ответят ответит ответили
просьба: просьба просьбу
прокомментировать: прокомментировать
публикация: публикаций публикация публикации публикацию
неустановленный: неустановленные
несколько: несколькими нескольким несколько нескольких
увеличить: увеличить увеличила увеличена увеличили
концентрация: концентрацию концентрации концентрациях концентрация
щёлочь: щёлочь щёлочи
оператор: операторы оператору оператор операторам операторами оператора операторов
своевременно: своевременно
заметить: заметить заметил заметили
вернуть: вернули вернул вернуть
значение: значение значения
параметр: параметр параметров параметры параметра
результат: результатам результате результаты
количество: количествах количество количеству количества
попасть: попавшие попавшего попала попал попасть
гидроксид: гидроксид гидроксида
натрий: натрия
оказаться: оказалось оказалась оказались оказался
минимальный: минимальным минимальные
потребитель: потребителям потребителей
угрожать: угрожало угрожает
утверждать: утверждает утверждают утверждали утверждал
шериф: шерифа шериф
округ: округов округа округе
пинелласа: пинеллас
боб: боб
гуалтьери: гуалтьери
обеспокоиться: обеспокоились
поскольку: поскольку
существенный: существенную существенными существенное существенных существенные
высокий: высокие высока высоком высокая высокой высокое высоким высоких
вызывать: вызывают вызывать вызывает
раздражение: раздражения
кожа: кожи
глаз: глаз
химический: химические
ожог: ожоги
тяжёлый: тяжёлых
амасессия: амасессия амасессию
service: service
mesh: mesh
блог: блогах блог блога блоге
southbridge: southbridge
рейтинг: рейтинге рейтинг
обеспечивать: обеспечивающая обеспечиваем обеспечивать обеспечивает
стабильный: стабильную стабильной
highloadпроект: highloadпроектов
слёрма: слёрма слёрм
провести: провел провела проведет провели провести проведёт
оставить: оставили оставят оставить
заранее: заранее
эксперт: эксперты эксперта экспертом экспертами экспертов
отвечать: отвечающей отвечают отвечала отвечать
самый: самых самую самый самая самые самым самое
популярный: популярна популярные популярный популярного популярных популярным
мероприятие: мероприятие мероприятиях мероприятия мероприятию
понять: пойму понять понял поняли
насколько: насколько
ваш: ваших вашего вашей вашу ваши вашему
возможно: возможно
частично: частично
выбрать: выбран выбрать выбрана выберут выбрали
конфигурация: конфигурации конфигураций
писать: пишет пишете пишут пишите писали писать
serviсe: serviсe
столкнуться: столкнутся столкнулись столкнуться
интересно: интересно
начать: начать начал начали начнут
смотреть: смотрите смотрели смотреть
qaсессия: qaсессия
давать: дают даёт дает давали давала давать
ответ: ответа ответах ответов ответы ответ
наш: нашем нашим наших нашего наши нашей наш наше наша
пройти: прошли пройдет пройдёт прошёл
видеоформат: видеоформате
ведущий: ведущих ведущим ведущие ведущий
озвучивать: озвучивать
чат: чатов чате чат чата чатам
форма: форму форма формы формой форме
отличие: отличий отличие
митапа: митапа
круглый: круглого круглый
стол: стол стола
дискуссия: дискуссию
ценность: ценность
заключаться: заключалась заключающуюся заключается
донесение: донесении
опыт: опытом опыта опыт опыте
кратко: кратко
понятно: понятно
раскрыть: раскрыть раскроет
тема: тема тему темой
дата: дата дату даты
проведение: проведение проведении проведением проведения
utc: utc
стоимость: стоимости стоимостью стоимость
бесплатно: бесплатно
студент: студентами
выпускник: выпускник выпускниками выпускников
онлайнинтенсив: онлайнинтенсивы
apple: apple
заменить: заменить заменит
аккумулятор: аккумуляторы аккумулятора аккумуляторов
macbook: macbook
pro: pro
замена: замены
модель: модели моделей модель
выпуск: выпуске выпуском выпусков выпуск выпуска
учаcтие: учаcтие
батарейapple: батарейapple
выпустить: выпустить выпущено выпустила выпустили выпущенные выпущен выпущенных выпустил выпустит
обновление: обновление обновлении обновлением обновлений обновлению обновления
macos: macos
catalina: catalina
исправить: исправить исправлена исправили
ошибка: ошибкой ошибку ошибками ошибках ошибка ошибке ошибок ошибкам ошибки
батарея: батарее батареи
заряжаться: заряжаться
патч: патч патчи патче патчем
обратиться: обратилась обратиться
отнести: отнести
ноутбук: ноутбук ноутбука ноутбуках ноутбуки ноутбуков
сервисный: сервисный
центр: центр центра центров центрам центром
заявлять: заявлял заявляет заявляют заявляли
очень: очень
небольшой: небольших небольшое небольшим небольшие
клиент: клиентами клиентов клиенты клиента клиентам
сталкиваться: сталкивается
узнать: узнать
состояние: состояние состоянии
устройство: устройствах устройствам устройствами устройств устройство устройства устройстве устройству
нажать: нажав
значок: значок
системный: системному системного системные
настройка: настройках настройке настройки настроек
у: у
затронуть: затронет затронуть затронутых затронуло
показывать: показывает показывают показывать
рекомендоваться: рекомендуется
обслуживание: обслуживания обслуживание
ниже: ниже
перечислить: перечислены
запускать: запускали запускала запускать запускает
октябрь: октябрь октябре октября
некоторый: некоторых некоторые некоторым некоторого
вздуваться: вздувались
запустить: запустить запущена запустит запустили запустила запустило запустив запустил запущен
клавиатура: клавиатуры
страдать: страдают
залипаний: залипания
невосприимчивость: невосприимчивости
клавишоб: клавишоб
история: историями историй историю истории история
удачный: удачных
прочитать: прочитать
вирусный: вирусный вирусным
фильтр: фильтром фильтр фильтров
я: я меня
кот: кота кот
видео: видео
техасский: техасский
адвокат: адвокат
появляться: появляются появляется появляться
кошачий: кошачьим кошачий кошачьей
онлайнзаседание: онлайнзаседании
суд: суде суд суда
zoom: zoom
оправдываться: оправдывается
заинтересоваться: заинтересовались
ктоть: ктото
предположить: предположил
юрист: юрист юристов
дипфейктехнология: дипфейктехнологию
но: но
дело: деле дела дело
гораздо: гораздо
простой: простоев проще простой простое
выясниться: выяснилось
включить: включённой включить включив включен включил
предустановленный: предустановленное
dell: dell
причём: причем
софт: софта софту софт
live: live
cam: cam
avatar: avatar
доступно: доступно
загрузка: загрузок загрузку загрузки загрузка загрузке
делиться: делитесь делиться
ник: ником
chembark: chembark
грустный: грустным
котёнок: котенком
собеседование: собеседований собеседовании
skype: skype
отчаянно: отчаянно
скроллить: скроллить
меню: меню
пытаться: пытаясь пытается пытаться пытались
ситуация: ситуацию ситуации ситуация
жаловаться: жаловались жалуется жалуются жаловаться
настроить: настроена настроено настроить
умолчание: умолчанию
вебкамера: вебкамеры вебкамер вебкамере
пост: постов пост поста
подробный: подробного подробные подробнее
инструкция: инструкции инструкцией
удаление: удаления удалением удалению удалении удаление
глупый: глупого
белый: белого белый белым
reallusion: reallusion
описать: описали описана описала
настраивать: настраиваемую
анимация: анимацией анимацию анимации
эмоция: эмоциями
доставить: доставит
удовольствие: удовольствия
обычный: обычный обычной обычные обычных
видеочат: видеочат
настоящий: настоящей настоящих настоящее настоящий
разрабатывать: разрабатывала разрабатываемых разрабатываемая разрабатывать разрабатывает
сложный: сложны сложной сложнейшего сложных сложную сложное
реальный: реальном реального реальными реальным реальные реальных реальной
пока: пока
правда: правда
вскрыться: вскрылась
наслать: нашли
альтернативный: альтернативный альтернативные
способ: способы способом способ способов
создание: создании создания созданию создание созданием
приложение: приложением приложение приложении приложению приложений приложения
snapchat: snapchat
snap: snap
camera: camera
facebook: facebook
трансляция: трансляция трансляции
прессконференция: прессконференции
пакистанский: пакистанского
политика: политики политика политике
превратиться: превратилась превратиться
фарс: фарс
выставить: выставят выставили выставил
язык: языка язык языке языком
go: go
наконецтый: наконецто
дженерик: дженерики дженериков
proposal: proposal
как: как
телеграмканал: телеграмканалов телеграмканале телеграмканал
добавление: добавлению добавлением
документ: документа документах документы документ документами документам документе
type: type
stringer: stringer
interface: interface
string: string
plusser: plusser
plusstring: plusstring
func: func
p: p
r: r
lens: lens
for: for
i: i
v: v
range: range
s: s
return: return
означать: означает
скорее: скорее
попробовать: попробовать
цитата: цитата
официальный: официальный официальном официальных официального
постараться: постараются постарались постарается
какойтый: какойто
вариант: вариант варианты
слишком: слишком
оптимизировать: оптимизированный оптимизировать
поиграться: поиграться
поздравлять: поздравляем
гофер: гоферов
отличный: отличных отличной отличный
новость: новостью новостях новостей новостями новости
тимлида: тимлид
подкаст: подкаста подкастов подкаст
цинковый: цинковый
прод: прод
раздать: раздаст
отследить: отследили отследить
распространение: распространение распространении распространением распространения
выдать: выдало выдаст
пилотный: пилотную пилотной
сдерживание: сдерживанию
коронавирусас: коронавирусас
умный: умные умных умное
браслет: браслетов
ежедневно: ежедневно
отслеживать: отслеживать отслеживает отслеживают
ключевой: ключевым ключевые ключевого ключевых
показатель: показатели показатель показателей
здоровье: здоровью здоровья
частота: частотах частоты частоте частотой частоту частот
пульс: пульса
дыхание: дыхания
покой: покоя
носить: носит носимых носили носимые
выявить: выявить выявили
гриппоподобный: гриппоподобное
заболевание: заболевание
появление: появлению появлении появления
симптом: симптомов
важно: важно
передать: передала передать
вирус: вирус
протекать: протекает
бессимптомный: бессимптомно
функция: функцию функцией функциях функции функций функция
позволять: позволяя позволяет позволяющая позволяющими позволяющий позволяла позволяющей позволявший позволял
регистрировать: регистрировать регистрируют
основа: основе основу
предоставить: предоставит предоставить предоставили предоставлено предоставила предоставленное предоставят предоставленные
сам: сами самого самом сама сам само самой самих
температура: температуре температурах температуры
тело: тела
идти: идет идти идут
оставаться: остается оставалось оставаться
доманас: доманаса
оценить: оценили оценит оценить
рассмотреть: рассмотреть рассмотрено рассмотрит рассмотрим
расширение: расширению расширении расширение расширений расширения расширением
широкий: широкий широк
круг: кругов круг кругах
годовой: годовой
premiumtmнас: premiumtmнаса
принимать: принимавший принимать принимает
мера: мер меры мере
предотвращение: предотвращению предотвращения
объект: объект объектах объектов
перевести: переведённый перевело переведет
везде: везде
предназначить: предназначена предназначенной предназначен
дополнение: дополнение дополнений дополнения
стэнфордский: стэнфордский
польза: пользы
обнаружение: обнаружении обнаружение обнаружения
различный: различных различным различные различными
garmin: garmin
производитель: производителем производители производителей производителям производителя производителями
показать: покажет показала показало показал покажем
заболеть: заболевших
гаджет: гаджеты
фиксировать: фиксирована фиксировали
девять: девять
день: днем дне дней дни дня днях день
android: android
jetpack: jetpack
activity: activity
result: result
api: api
рефакторинг: рефакторинга рефакторинг
fragment: fragment
привет: привет
с: с
вы: вы вам вас вами
broadcast: broadcast
неделя: недели неделе неделю недель
очередной: очередной
релиз: релиз релизе релизы релиза релизами релизах
библиотека: библиотек библиотеки библиотека библиотеках библиотеке
google: google
мы: нам мы нами
выйти: вышла вышедшей вышел вышло выйти выйдет
долгожданный: долгожданное
исправление: исправления исправление исправлений
множество: множеству множества
баг: баг багов
изз: изза
внутри: внутри
fragmentmanager: fragmentmanager
интересный: интересных интересные интереснее интересное
найти: нашёл найти найдено найдете
подробность: подробности
узнавать: узнают узнавать
разработка: разработку разработка разработке разработки разработкой разработок
подписаться: подписаться подпишитесь
следить: следить следил следите следит
формат: форматы формата форматов формате формат
искать: ищем искать ищет ищите
признак: признаки признаков признакам признака
жизнь: жизни
загрязнить: загрязненных
планета: планету планетах планете планет планеты
поиск: поиска поиск
внеземной: внеземную внеземных
цивилизация: цивилизацию цивилизации цивилизаций
потенциально: потенциально
присутствовать: присутствовали присутствующих присутствовать
наблюдаться: наблюдается
атмосферный: атмосферное
загрязнение: загрязнение
газообразный: газообразного газообразный
диоксид: диоксид диоксида
азот: азота
земля: земле земли
образоваться: образуется
сжигание: сжиганием сжигании
ископаемое: ископаемого
топливо: топлива
активность: активности
вулкан: вулканов
равить: рави
коппарап: коппарапу
имя: именем имен именах имени имена именами
годдард: годдарда
гринбелт: гринбелте
отмечать: отмечаем отмечает отмечают отмечал
нижний: нижней нижних нижние
слой: слоя слой слои слоях
атмосфера: атмосферой атмосфере атмосферу атмосферы
высота: высотой высоте высота
км: км
промышленный: промышленные промышленной промышленную промышленных промышленного промышленное промышленным промышленный
происхождение: происхождения происхождение
преобладать: преобладает преобладающей
следовательно: следовательно
указывать: указывает указывать указывают
индустриальный: индустриальной
сегодняшний: сегодняшние сегодняшний
астроном: астрономы
обнаружить: обнаружить обнаружили обнаружил обнаружена обнаруженных
вращаться: вращающихся вращающиеся
вокруг: вокруг
звезда: звезды звезд
подходящий: подходящие
экзопланета: экзопланеты
удалить: удалила удалена удалили удалены удалил удалить удалит удалено
учёный: учёные ученых учёным ученые ученым
мощный: мощнее мощным мощный мощная мощной мощные
телескоп: телескопы телескопов
изучать: изучать изучают
качество: качестве качества качество качеству
рассматриваться: рассматриваются рассматривалось
кислород: кислорода
метан: метане метана
выявлять: выявлять
изучаться: изучались
хлорфторуглерод: хлорфторуглероды
техносигнатура: техносигнатур
широко: широко
использоваться: использоваться используется используются использовались использовался
пора: пор поры
истощать: истощает
озоновый: озоновый озонового
хфу: хфу
являться: являющиеся являлись является являются
парниковый: парниковых парниковым
газ: газом газа газ газов
производиться: производиться производятся производится
биологический: биологическими
источник: источником источника источник источниками источники
специфический: специфические
вещество: вещества веществ
встречаться: встречаться
побочный: побочным
продукт: продукт продукты продукта продуктах продукту продуктами продуктом продуктов
любой: любого любые любой любом любому любым любых любое
сгорание: сгорания
компьютерный: компьютерное компьютерной компьютерных
моделирование: моделирования моделирование
предсказать: предсказать
обнаруживаться: обнаруживаться
существующий: существующих существующего существующей существующую
поглощать: поглощают поглощает
длина: длины длиной длинах
волна: волн волны
видимый: видимого видимая
свет: света свет
подтверждать: подтверждать подтверждают подтверждает
расстояние: расстояние расстоянии
световой: световые световых
примерно: примерно
часами: часами
наблюдение: наблюдения наблюдений наблюдениям
холодное: холодные
солнце: солнцу солнце
производить: производит производить
сильный: сильный сильнее сильные
легко: легко
обнаруживать: обнаруживают обнаруживаемый обнаруживать
сигнал: сигнала сигнал сигналов
излучать: излучают
маленький: мала маленькая маленького меньше
ультрафиолет: ультрафиолета
сложность: сложности сложность
состоять: состоит
иметь: имеют имеющий имеющие имел иметь имеет имеющих
выброс: выбросов
приходиться: приходилось приходится
деятельность: деятельность деятельности
соотношение: соотношение
естественный: естественным естественного
потребоваться: потребуется потребовались
при: при
вероятность: вероятность
ложный: ложного ложных
срабатывание: срабатывания
помешать: помешать
облако: облаков облака облаке
аэрозольный: аэрозольные
газа: газы
имитировать: имитировать имитируют
сигнатура: сигнатуру
для: для
отличить: отличить
продвинуть: продвинутые
руководство: руководства руководством
массачусетский: массачусетского массачусетский
институт: институт института
многопланетный: многопланетную
четыре: четырьмя четыре четырёх
наблюдать: наблюдать наблюдали
эволюционировать: эволюционируют
фас: фас
возбудить: возбудила возбудило возбудили
против: против
тариф: тарифов тарифы тарифах тарифам
антимонопольный: антимонопольных антимонопольная
прессрелиз: прессрелизе
сайт: сайт сайте сайтов сайта сайтах сайты
миллион: миллиона миллионов миллион миллиону миллионах миллионы
поступить: поступившим поступила поступило поступившего
большой: большого велика большое большой
жалоба: жалобы жалоб жалобу
говориться: говорится
повысить: повысил повысить повысила повысили
конкуренция: конкуренцию конкуренции
установление: установление
поддержание: поддержание
монопольно: монопольно
низкий: низкой низким низкие низких низкими
товар: товара товаров
ущемлять: ущемляет
интерес: интересам интересы
иной: иные иной
обоснование: обоснование обоснования
интерфакс: интерфаксу
действительно: действительно
повыситься: повысилась
коснуться: коснулось
ряд: ряда ряду ряд
архивный: архивных
меняться: меняется меняются менялась менялись
прежде: прежде
среднее: среднем среднего
пересмотр: пересмотр
рубль: рубля рублей
заверить: заверили
обусловить: обусловлено
инвестиция: инвестиции инвестиций
фон: фоне
рост: росту рост роста ростом
пользовательский: пользовательский пользовательские пользовательского
трафик: трафика трафик
предупредить: предупредил предупредила предупредить
июль: июля июле июль
регулятор: регулятора регулятор регуляторов
два: два двух две двумя
признать: признали признала
незаконно: незаконно
недостаточный: недостаточным
согласиться: согласился согласились согласиться согласится
вывод: вывода выводы вывод выводу выводах выводами
уверять: уверяли уверяет уверяют
затрагивать: затрагивало
оспаривать: оспаривает оспаривая
мвд: мвд
госзакупка: госзакупку госзакупок госзакупках
изучение: изучение изучения
борьба: борьбы борьбе
дипфейк: дипфейками дипфейков
фото: фото
вестиhitech: вестиhitech
портал: портал портала портале
тендер: тендер тендеров тендеру
выявление: выявления
внутрикадровый: внутрикадрового
монтаж: монтажа
видеоизображение: видеоизображений
выполнить: выполненного выполнили выполните выполнить выполнив выполнена выполнил
нейронный: нейронных
шифр: шифр
зеркало: зеркало
верблюд: верблюд
научный: научного научный научной научных научном научными
изыскание: изысканий
исполнитель: исполнитель
технический: техническое техническим технических технический технического технические техническими техническую
задание: заданием задание
программноаппаратный: программноаппаратного
комплекс: комплекса комплекс комплексу
инициатор: инициатором
выступить: выступило выступил выступили
фку: фку
научнопроизводственный: научнопроизводственное
объединение: объединение
специальный: специальный специальную специальная
техника: технике техникой техника технику
первоначальный: первоначальных первоначальные первоначальная первоначальный
исследовательский: исследовательские исследовательских исследовательского исследовательским исследовательской
материал: материалам материалов материала материал материалы
ход: ходу ходе ход
уровень: уровень уровня уровнем уровне
научнотехнический: научнотехнического
экспертнокриминалистический: экспертнокриминалистических
подразделение: подразделение подразделений
линия: линий линии
производство: производства производство производству
видеотехнический: видеотехнических
экспертиза: экспертиз
конкурс: конкурсов конкурса конкурс
комплексный: комплексная комплексный
анализ: анализа анализе анализ анализу анализов
делать: делаем делали делают делать делает
предусматривать: предусматривает предусматривают
систематизация: систематизацию
доступный: доступны доступна доступных доступными доступен
зарубежный: зарубежных зарубежным зарубежном зарубежные
видеозапись: видеозаписей видеозаписи
нейросеть: нейросетей нейросети нейросеть
изучить: изучить
содержаться: содержались содержащимся содержащихся содержится
видеофайл: видеофайлах
распространить: распространенная распространенных
представить: представленных представлены представили представит представила представленная
обстоятельство: обстоятельствах
получение: получения получение
интернет: интернета интернете интернет
контракт: контракт
теоретический: теоретической теоретического теоретическое
патентный: патентных
модуль: модули модулей модуля модулем модуль
антимошенник: антимошенник
мобильный: мобильном мобильным мобильное мобильной мобильного мобильных мобильные мобильный
ios: ios
встроить: встроили встроенную встроенные встроить встроены встроят встроена встроенной
полиция: полиция полицией полиции
мошеннический: мошеннических мошенническими
смсрассылка: смсрассылками
осень: осенью
microsoft: microsoft
фотография: фотографиях фотографий фотография
она: ей она неё
дезинформация: дезинформации дезинформацией
контент: контентом контент контента контенту
кандидат: кандидат кандидатами кандидатов
президентский: президентских президентская
выборы: выборов
подделка: подделок
минцфира: минцфиры
допустить: допустить допустим
реестр: реестра реестр
отечественный: отечественном отечественного отечественных
условно: условно
переработать: переработанные
переработка: переработку переработка
постановление: постановление постановлению
импортозамещение: импортозамещении
доказательство: доказательство доказательствами доказательства доказательств доказательству
оригинальность: оригинальности
обсуждаться: обсуждалось обсуждалась
экспертный: экспертный экспертном
совет: советы совете совета советами совет
внести: внести внесены внесли
дополненийоднако: дополненийоднако
финальный: финальной
образ: образом
включение: включения включение включении
претендовать: претендует претендовать
элемент: элементы элементами элементов
копия: копию копии копия
иностранный: иностранных иностранными
свободный: свободных свободное свободный свободным
участвовать: участвующие участвовали участвовать
есть: есть
бонус: бонусы
предусмотреть: предусмотрен предусмотреть предусмотрена
льготный: льготная
налог: налогу
понизить: пониженные пониженного
страховой: страхового страховые
взнос: взносы
исчезнуть: исчезло исчезнет
упоминание: упоминания упоминание
квота: квоте
ассоциация: ассоциаций
спо: спо
распространяться: распространяются распространяется
лицензия: лицензий лицензию лицензией лицензиям лицензии
существенно: существенно
доработать: доработать
исключительный: исключительные
право: права правами право
производный: производный
входить: входят входил
базальт: базальт
astra: astra
linux: linux
мой: мой
alteroffice: alteroffice
единственный: единственный единственным
случаем: случаем
исключение: исключением исключения
компанияразработчик: компанияразработчик
взять: взяли взять взяла
основательный: основательную
часть: частей частью части часть
автор: авторы авторам автор авторов
libreoffice: libreoffice
обладать: обладает обладающими
сообщество: сообществами сообщество сообщества сообществ
document: document
foundation: foundation
доработка: доработку доработки
уникальность: уникальность
фиктивный: фиктивные
вносить: вносят
полноценный: полноценными полноценного полноценную полноценным полноценная
роль: роль
номинальный: номинальная номинальной номинальна
юридический: юридических юридической
фирма: фирмы
антон: антон антона
серго: серго
обеспечить: обеспечить обеспечит
поддержка: поддержку поддержки поддержка поддержкой поддержке
собственный: собственные собственный собственным собственную собственного
перепродавать: перепродавать
наносить: наносить
вред: вред вреда
нести: несет несут
расход: расходов расходы
попрежний: попрежнему
полный: полный полон полны полную полное полного
распространять: распространяемыми распространять
условный: условным
лишь: лишь
перевод: перевод переводе
русский: русский
сетовать: сетует
ввезти: ввезли
партия: партию
оборудование: оборудование оборудованием оборудования оборудовании
майнинга: майнинге майнинга майнингу
разовый: разовую
майнинговый: майнингового
мощность: мощности мощность
мвт: мвт
розничный: розничного
основатель: основателя основатель основателями
датацентр: датацентра датацентров
bitriver: bitriver
игорь: игорь
рунец: рунец
поставить: поставлено
после: после
поставка: поставок поставки
иркутский: иркутском
братск: братске
запуститься: запустился запустилась
обособленный: обособленного обособленный
цод: цод
tieriii: tieriii
bloomberg: bloomberg
находиться: находится находятся находиться находились
майнингферма: майнингферма
принадлежать: принадлежит принадлежат
миллиардер: миллиардеру
дерипаск: дерипаске
ферма: фермы
целое: целом целого
япония: японии
китай: китае китая китай
закупить: закупили закупить
азия: азии
название: названием название
раскрываться: раскрывается
chilkoot: chilkoot
артём: артем
ерёмин: еремин
обычно: обычно
специализировать: специализированное
asicчип: asicчипах
бренд: брендов бренды брендом бренд
bitmain: bitmain
whatsminer: whatsminer
innosilicon: innosilicon
avalon: avalon
sixnines: sixnines
трошин: трошин
уверенный: уверен
закупаться: закупались
современный: современных современные современной
btc: btc
asic: asic
подсчитать: подсчитал
майнить: майнить
мировой: мировом мировой
биткойнсеть: биткойнсети
оценка: оценка оценкам оценку оценке
третий: третьего третьими третьей третий третьим третье третья
расти: растущем растущей растут
капитализация: капитализации капитализация
биткоина: биткоина биткоин биткоины
майнер: майнеры майнерам
завозить: завозить
отрасль: отрасль отрасли
определённый: определенных определенным определенные
уверить: уверены
негласный: негласное
разрешение: разрешение разрешения разрешением
финансовый: финансовый финансовым финансовые финансовыми финансовое финансовых финансовой
актив: активы активах активам активов
заработать: заработают заработал заработать
туманный: туманным
вводить: вводящий вводит вводят
понятие: понятие
криптовалюта: криптовалюты криптовалюте криптовалюту криптовалютам
запрещать: запрещающим запрещающий запрещает запрещают
её: её
оплата: оплату оплата оплаты оплате
законодатель: законодатели
пообещать: пообещала пообещали
минфин: минфин
уголовный: уголовный
уголовнопроцессуальный: уголовнопроцессуальный
валюта: валюты валюте валюту валюта валют
декларировать: декларирующих
иходнако: иходнако
бизнес: бизнеса бизнес
легализовать: легализован
течение: течение
оценивать: оценивает оценивают оценивать
задействовать: задействованных задействует задействованы
человекраный: человекранее
резкий: резкого
сильно: сильно
вырасти: выросла выросли
продажа: продажу продажи продаже продаж
видеокарта: видеокартами видеокарты видеокарт
окупаемость: окупаемости
упасть: упали упал
одновременно: одновременно
дефицит: дефицит дефиците дефицита
топовый: топовые
пропасть: пропали пропало
спектрометр: спектрометра спектрометром спектрометр
марс: марса марсе марс
хлороводород: хлороводорода хлороводород
atmospheric: atmospheric
chemistry: chemistry
suite: suite
химия: химии
acs: acs
измерение: измерениями
известно: известно
солнечный: солнечной
венера: венере
составной: составной составных
tras: tras
gas: gas
orbiter: orbiter
совместный: совместную совместного совместное совместный совместной
российскоевропейский: российскоевропейского
исследовать: исследует исследуют исследовал
распределение: распределение распределению
вместе: вместе
аппарат: аппаратом аппарат аппарате
бельгийский: бельгийский бельгийской
nomad: nomad
анализировать: анализирует анализируя анализировать
компонент: компонент компонентов компоненты
марсианский: марсианской марсианскую марсианского марсианских марсианском
hcl: hcl
попадать: попадает попадало
море: моря
частица: частицы частицами
морской: морских морские
соль: солей
превращаться: превращаются
аэрозоль: аэрозоль
реагировать: реагирует
озон: озоном
гидроксильный: гидроксильными
радикал: радикалами
зависеть: зависит зависят
окислительный: окислительные
свойство: свойства свойств
сезонный: сезонного
утончение: утончения
полюс: полюсами
выступать: выступаем выступает
главный: главных главными главная главный главной главным
хлор: хлора
стабильность: стабильность стабильности
углекислотный: углекислотной
высказывать: высказывали
предположение: предположения
следовой: следовых
миллиард: миллиард миллиарда
единица: единиц единице
объём: объём объёмом объёму объема объёма объем объемах
ppbv: ppbv
удаваться: удавалось
полгода: полгода
северный: северном северную
полушарие: полушарии
глобальный: глобальное глобальных глобальная глобальном глобальной глобальным
пылевой: пылевых пылевая
буря: буря бурей бури бурь
поднимать: поднимала
пыль: пыль пыли
поверхность: поверхности поверхностью поверхностей
прохождение: прохождению
перигелий: перигелий
близкий: ближайшую ближайшем ближайшее ближайшие
точка: точек точке точку точки
кораблёва: кораблёва
разнести: разнести
что: чего чему что
обнаруженлиния: обнаруженлинии
поглощение: поглощения
хлорводород: хлорводорода
марсавслед: марсавслед
последовать: последовала
малый: меньших наименьшие меньшими малых
размер: размере размеров размером размера размер
наличие: наличие наличия
средний: средних средняя
широта: широтах
колебаться: колебалась
окончание: окончания
пылев: пылевой
перестать: перестали перестал
детектировать: детектировать детектируют
следовать: следует следуют следовать
представление: представления
неясно: неясно
откуда: откуда
браться: берётся
уходить: уходит
acsучёный: acsучёные
выдвигать: выдвигают
основной: основные основной
гипотеза: гипотезы гипотезе гипотезу
подниматься: поднимается
выделяться: выделяется
активный: активных активной активное активного
вулканизм: вулканизма
оба: оба обе обеих обоих
недостаток: недостатки недостатков недостаток
механизм: механизм механизмов
превращение: превращения
минерал: минералов
непонятный: непонятен
возникать: возникают возникать возникает
сейсмический: сейсмической
объяснять: объясняет объясняют
пропадать: пропадает
существовать: существует существуют
некий: некое
взаимодействие: взаимодействие
учитываться: учитывалось
продолжать: продолжают продолжает
надеяться: надеются надеюсь надеется
достаточный: достаточные достаточным
разгадка: разгадки
epic: epic
games: games
персонаж: персонажей
metahuman: metahuman
creator: creator
реалистичный: реалистичные
человеческий: человеческим человеческих человеческими человеческого
мимика: мимики
движок: движка движке
unreal: unreal
engine: engine
прямо: прямо
браузер: браузер браузеры браузере браузерах браузеров браузера
значительно: значительно
сократить: сократит сократила сократить
требоваться: требовалось требуется
желать: желающий желающих желающему
пк: пк
pixel: pixel
streaming: streaming
менять: менять
черта: черты
анимировать: анимированных анимировать
волос: волос волоса
цвет: цвет цвета цветом
зуб: зубов
телосложение: телосложений
причёска: причёсок
образец: образцов образцы
одежда: одежды
обещать: обещает обещала
расширять: расширять
адаптировать: адаптировать
нужда: нужды
quixel: quixel
bridge: bridge
захват: захвата
манипулировать: манипулировал манипулировать
поддерживать: поддерживают поддерживает поддерживающее поддерживать поддерживающих
анимирование: анимирования
link: link
face: face
вицепрезидент: вицепрезидента вицепрезидент
владимир: владимира
мастилович: мастиловича
десятилетие: десятилетия десятилетие
тратить: тратить
усилие: усилий
ранний: раннем раннего ранних раньше ранние
store: store
qualcomm: qualcomm
snapdragon: snapdragon
модем: модема модем
скачивание: скачиваний скачивание скачиванию скачивания
автономный: автономных автономного автономная
неавтономный: неавтономных
предшественник: предшественников предшественника
превышать: превышает превышал
сравнение: сравнения сравнении сравнению
чипсет: чипсет
mediatek: mediatek
максимальный: максимальную
huawei: huawei
balong: balong
отмечаться: отмечается
стандарт: стандарт стандартах стандартам стандарты
ежемесячный: ежемесячная ежемесячного
потребление: потребления потребление
гб: гб
превышение: превышением превышения
лимит: лимитов лимита
ограничиваться: ограничивается
совместимый: совместимым совместимы
спецификация: спецификациями спецификациям
release: release
улучшить: улучшенную улучшенные
mimo: mimo
энергопотребление: энергопотребление энергопотребления
позиционирование: позиционирование
развёртывание: развертывания развертывание
промышленность: промышленность промышленности
включать: включают включаемых включать включающему включает включали
нелицензированный: нелицензированного
спектр: спектра
непубличный: непубличных
архитектура: архитектуры архитектуре архитектура архитектурой архитектур
модемный: модемной
обновляться: обновляться обновлялась
хотя: хотя
заморозить: заморозили заморожен заморожено заморозило
дополнительный: дополнительной дополнительным дополнительными дополнительные дополнительного дополнительную дополнительное
протяжение: протяжении
жизненный: жизненного
цикл: цикла
загружать: загружает загружаемым загружали загружают загружаемых
прошивка: прошивка прошивки
анонсировать: анонсировала
антенна: антенну антенны антенне
гигабит: гигабит
наконец: наконец
qtm: qtm
mmwave: mmwave
диапазон: диапазоне диапазона диапазонов диапазон диапазонам диапазонах
производительность: производительности производительность
точнее: точнее
держать: держать держит
телефон: телефон телефоны телефонов
wus: wus
оно: оно
флагманский: флагманской
однокристалльный: однокристалльной
приобретение: приобретении приобретения
nuvia: nuvia
стартап: стартап стартапа стартапов
процессор: процессоры процессор процессорами процессором процессоров процессора процессорах
обработка: обработку обработки обработке обработка
рассчитывать: рассчитывает рассчитывают
чип: чип чипе чипа чипы чипом чипами чипах
ориентировать: ориентированный ориентированные
смартфон: смартфона смартфонах смартфонов смартфон смартфоны
samsung: samsung
galaxy: galaxy
техпроцесс: техпроцессу
ядро: ядрам ядра
беспроводный: беспроводные
wifi: wifi
перед: перед
утечь: утекших
файл: файлу файлам файлом файлами файлах файлов файлы файле файл файла
примечательно: примечательно
датировать: датирована
вчера: вчера
указать: указано указала указали
разведка: разведки разведка
dlbi: dlbi
ашот: ашот
оганесян: оганесян
сегодня: сегодня
утром: утром
форум: форуме форума форум
выложить: выложена выложили
архив: архива архив
игра: игр игры игра
gwent: gwent
witcher: witcher
card: card
game: game
зашифровать: зашифрованы
сохраниться: сохранились
резервный: резервные
восстановление: восстановление восстановления
дрифт: дрифт
стиковый: стиков
dualsense: dualsense
playstation: playstation
массово: массово
геймпадов: геймпадов
полмесяца: полмесяца
покупка: покупке покупки покупку
консоль: консоли консолей
приводить: приводит
аналоговый: аналоговые
стик: стики
неправильно: неправильно
игрок: игрокам игрока игроках игроков
срабатывать: срабатывают
касание: касания
reddit: reddit
управиться: управиться
джойстик: джойстиком
destiny: destiny
за: за
immersion: immersion
joycon: joycon
nintendo: nintendo
switch: switch
объявить: объявил объявит объявлен объявила
пострадать: пострадавших пострадавшим
ремонт: ремонт
компенсация: компенсацию компенсации компенсация
обращаться: обращаться
гарантийный: гарантийные
обязательство: обязательства
доставка: доставкой доставки доставку
геймпада: геймпада
заплатить: заплатит заплатить
sony: sony
комментировать: комментирует
ситуациюкомпания: ситуациюкомпания
контроллер: контроллер
тактильный: тактильную
обратный: обратной обратные обратную
драйвер: драйвер драйвере драйверах
hidplaystation: hidplaystation
linuxсистема: linuxсистемах
tsmc: tsmc
дисплей: дисплеями дисплея дисплею дисплеев дисплеи
поколение: поколения
arочки: arочков
vrгарнитур: vrгарнитур
nikkei: nikkei
сотрудничество: сотрудничестве сотрудничество
taiwan: taiwan
semiconductor: semiconductor
manufacturing: manufacturing
co: co
micro: micro
oled: oled
устанавливаться: устанавливаются устанавливаться
непосредственно: непосредственно
пластина: пластине пластина пластины
микросхема: микросхему микросхем
стеклянный: стеклянные стеклянной
подложка: подложки
тонкий: тонкие тоньше
энергоэффективный: энергоэффективные
идеально: идеально
подходить: подходят подходит
очки: очки
glasses: glasses
слух: слухам
ожидаться: ожидалась ожидается
сверхкомпактный: сверхкомпактных
качественный: качественных
прототип: прототипов прототипы
ультрасовременный: ультрасовременных
секретный: секретных секретный секретной
фабрика: фабрику фабрике фабрика
тайвань: тайване
стадия: стадии
пробный: пробным пробного
вероятно: вероятно
лаборатория: лабораторий лаборатории
парка: парки парке
лонгтан: лонгтан
специализироваться: специализируется специализирующихся
отображение: отображения
учреждение: учреждений учреждениям учреждения
расположить: расположена расположены расположенных
ходьба: ходьбы
завод: заводы заводов завода заводах
нанимать: нанимает
специалист: специалиста специалисты специалистам специалистов
подчиняться: подчиняются
строгий: строгим строгой
соглашение: соглашениям соглашение соглашения
неразглашение: неразглашении
друг: друг друзьями другом друга
знакомый: знакомыми знакомые
направить: направила направлено направлены
снижение: снижения снижение
зависимость: зависимостей зависимости
основный: основная основных основным основного
oledдисплей: oledдисплеев
iphone: iphone
лето: летом
высококачественный: высококачественных высококачественные
watch: watch
ipad: ipad
сми: сми
поробность: поробности
гарнитур: гарнитуре
виртуальный: виртуальное виртуальной виртуальный виртуальных
реальность: реальности
оснастить: оснащено оснащенных оснащенными оснащен оснащена
десять: десяти десятью
отслеживание: отслеживание отслеживания
vrшлем: vrшлема vrшлем
функционировать: функционировать
дополнить: дополненной
путь: пути путь путями
конечный: конечном конечной
лёгкое: легкому
arустройство: arустройству
неотличимый: неотличимы неотличимые неотличимому
очко: очков
старший: старший
аппаратный: аппаратных аппаратной аппаратного аппаратная
соответствие: соответствии соответствия
европейский: европейских европейской
директива: директивой директиве
конфиденциальность: конфиденциальность конфиденциальности
содержимое: содержимое
сохранять: сохранять сохраняя сохраняли
отвергнуть: отвергли
претензия: претензии
относительно: относительно
инфраструктура: инфраструктур инфраструктуре инфраструктуры
отключать: отключать
речь: речи речь
сообщаться: сообщается сообщалось
предел: предел пределах пределами
локальный: локальными локального локальный локальной
выяснить: выяснить выяснила выяснили
хранить: хранит хранят
отправить: отправленная отправим отправленных отправят
отправляться: отправляется
снова: снова
создаваться: создается создаются
значит: значит
либо: либо
сохранный: сохранен
кэшировать: кэширован
почему: почему
отключить: отключили отключена отключить
еспредварительный: еспредварительный
просмотр: просмотр просмотре просмотра
кстати: кстати
поделиться: поделятся поделились поделиться поделимся
улучшение: улучшениями улучшению улучшение улучшения
личный: личной личные личными личных личную
явный: явного
регулироваться: регулируется
ибисследователь: ибисследователи
предупреждать: предупреждает предупреждают предупреждать
регион: регионах регионов регионам регионы региона
воздерживаться: воздерживаться
отправка: отправкой отправки
зонд: зондов зонд
оаэ: оаэ
успешно: успешно
альамаль: альамаль
надежда: надежду надежда надежде
объединить: объединенных объединили объединенной
арабский: арабских
эмират: эмиратов
снимать: снимает снимать
радиометрический: радиометрическую
калибровка: калибровку
представлять: представляют представляет представляющий представляем
себя: собой
сборка: сборку сборка сборки сборке сборок
линза: линзой линзу линза линз линзы
оптический: оптическими
uv: uv
vis: vis
искажение: искажение искажений
датчик: датчиков датчик
желание: желание желании
emus: emus
emarates: emarates
mars: mars
ultraviolet: ultraviolet
spectrometer: spectrometer
ультрафиолетовый: ультрафиолетовым
прибор: приборах прибор
выполнение: выполнении выполнения
emm: emm
термосферный: термосферной
экзосферной: экзосферной
изменчивость: изменчивости изменчивостью
emirs: emirs
интерферометрический: интерферометрический
термальный: термальный
инфракрасный: инфракрасный
энергетический: энергетический энергетические
баланс: баланс
климат: климате
циркуляциейнадежда: циркуляциейнадежда
совершать: совершать
виток: виток
часовэтый: часовэто
космос: космос космосе
пролететь: пролетел
свыше: свыше
три: трех трёх
достигнуть: достигнуть достигла
аппаратывластить: аппаратывласти
луна: луны луну
приземлиться: приземлиться
район: районов районах
охватить: охваченных
снимок: снимки
стрим: стрима стримом стрим
phpразработчик: phpразработчиков
никита: никитой никита
попов: поповым попов
skyeng: skyeng
онлайншкола: онлайншкола
читатель: читателей
хабов: хабов
php: php
событие: события событиях событий событиями
запомниться: запомнились
кто: кто кого кому
читать: читайте читали
слушать: слушали
набраться: набралось
позвать: позвать
частый: частые чаще
упоминать: упоминает упоминали
поговорить: поговорим поговорить
явление: явлением явлениях
разыграть: разыграем
пара: пару пара
фирменный: фирменные фирменных
слон: слонов слоны
ценный: ценным ценных
полезный: полезной полезными полезные полезного полезных
просто: просто
приятный: приятное приятных приятным
приз: призы призов
активист: активистов
добавить: добавила добавлен добавили добавленный добавлены добавлена добавит добавить
свежий: свежих
доклад: доклады докладов
когда: когда
суббота: суббота
утро: утра
киев: киеву
пилить: пилить
видеозвонок: видеозвонки
устроенный: устроен
фронт: фронт
бэк: бэк
решенийилья: решенийилья
левин: левин
поднять: поднять
видеоконференция: видеоконференцию
база: база базы базами базе
webrtc: webrtc
janus: janus
роман: романом романа роман
пронский: пронского
валентин: валентином валентин
удальцов: удальцовым удальцов
пых: пых
жук: жук
скобка: скобок
мязина: мязин
пятиминутка: пятиминутка
николай: николай
сумрак: сумрак
today: today
константин: константин
роспотребнадзор: роспотребнадзор роспотребнадзора роспотребнадзором
запретить: запретил запрещенной запретила запрещенного запрещенным запрещено запрещенную запретить запретили запрещены запретит запрещенная запрещенный
школьник: школьников школьникам
санитарный: санитарные санитарных санитарного санитарным
ребёнок: детям дети детей
школьный: школьного школьные
возраст: возраста
образовательный: образовательных образовательный
риа: риа
общественный: общественных общественного общественным
слушание: слушаний
воспитание: воспитания
отдых: отдыха
оздоровление: оздоровления
молодёжь: молодежи
начальник: начальник начальника
управление: управление управления управлении
надзор: надзора
ирина: ирина
шевкун: шевкун
брать: брать
школа: школу
родитель: родителями
общение: общение общения
запрещаться: запрещается
планшет: планшеты
моноблок: моноблоки
интерактивный: интерактивные
доска: доски
